3 2 1 0 0 6 0 8 . 0 1 7 6 0 . 0 "
" 3 3 1 0 0 9 9 2 . 0 1 2 4 8 . 0 "
" 3 4 1 0 0 3 5 2 . 0 1 2 0 0 . 0 "
" 3 5 1 0 0 2 5 7 6 . 0 8 3 2 . 0 "
" 8 7 1 0 0 5 8 0 . 0 1 2 6 6 . 0 "
" 8 8 1 0 0 6 5 0 . 0 1 2 4 8 . 0 "
" 8 9 1 0 0 4 8 0 . 0 1 2 7 4 . 0 "
" 9 0 1 0 0 5 7 8 . 0 1 3 1 4 . 0 "
" 9 1 1 0 0 6 8 0 . 0 1 3 0 6 . 0 "
" 9 2 1 0 0 7 7 6 . 0 1 2 5 0 . 0 "
"
