3 2 1 0 0 6 0 8 . 0 1 7 6 0 . 0 "
" 3 3 1 0 0 9 9 2 . 0 1 2 4 8 . 0 "
" 3 4 1 0 0 3 5 2 . 0 1 2 0 0 . 0 "
" 3 5 1 0 0 1 2 9 6 . 0 8 3 2 . 0 "
" 8 7 1 0 0 5 1 7 . 6 8 7 5 9 9 6 3 1 5 0 5 9 1 9 8 . 4 0 5 8 5 8 3 8 3 3 4 8 8 9 "
" 8 8 1 0 0 5 7 8 . 0 1 4 0 8 3 1 3 4 8 7 9 3 2 4 1 . 6 8 8 6 7 3 8 6 7 2 1 6 5 5 "
" 8 9 1 0 0 4 3 5 . 1 8 2 1 4 0 2 4 9 7 3 7 2 2 4 1 . 8 4 2 5 9 4 7 1 2 3 8 3 5 7 "
" 9 0 1 0 0 4 8 4 . 8 7 0 7 9 2 2 0 1 0 2 1 1 2 4 1 . 1 6 3 4 7 2 6 2 1 2 9 6 3 4 "
" 9 1 1 0 0 5 3 4 . 8 0 1 4 9 4 0 8 5 4 8 7 7 2 4 1 . 0 6 1 7 6 3 2 5 5 5 1 6 8 4 "
" 9 2 1 0 0 5 9 3 . 4 7 2 4 0 3 7 9 5 5 6 3 5 1 9 4 . 6 1 0 4 1 2 6 7 2 8 3 0 7 3 "
"
